#########
--------#
#-#-##-##
#-#-*#-##
#-####-##
#-#-#*-##
#-#-#####
#----#---
#-#######
